000000000000000000004000000000000000000000000000000000000000000000000000000000000000000000000000000000000000000000000000000000000000000000000000000000000000000000000000000000000000000000000000000000000000000000000000000000000000000000000000000000000000000000000000000000000000000
000000000000000000004000000000000000000000000000000000000022220000000000000000000000000000000000000000000000000000000000000000000000000000000000000000000000000000000000000000000000000000000000000000000000000000000000000000000000000000000000000000000000000000000000000000000000000
000000000000000000004000000000000000000000000000000000000211110000000000000000000000000000000000000000000000000000000000000000000000000000000000000000000000000000000000000000000000000000000000000000000000000000000000000000000000000000000000000000000000000000000000000000000000000
000000000000000000004000000000000000000000000000000000000111110000000000000000000000000222000000000022220000000000000000000000000000000000000000000000000000000000000000000000000000000000000000000000000000000000000000000000000000000000000000000000000000000000000000000000000000000
000000000000000000004000000000000000000000000000000000222111110000000000000000000000000010000000000001100000000000000000000000000000000000000000000000000000000000000000000000000000000000000000000000000000000000000000000000000000000000000000000000000000000000000000000000000000000
000000000000000000004000000000000000000000000000000022111111100000000000002222222000000000000000000000000000000000000000000000000000000000000000000000000000000000000000000000000000000000000000000000000000000000000000000000000000000000000000000000000000000000000000000000000000000
000000000000000000004000000000000000000000000000000011111111100000000000000111110000000000000000000000000000000000000000000000000000000000000000000000000000000000000000000000000000000000000000000000000000000000000000000000000000000000000000000000000000000000000000000000000000000
000000000000000000004000000000000000000000220000000011111111100000000000000011100000000000000000000000000000000000000000000000000000000000000000000002222200000002000000002222222222222000222000000000000000000000000000000000000000000000000000000000000000000000000000000000000000000
000000000000000000004000000000000000000002110000000001111111100000000000000000000000000000000000000000000000000000000000000000000000000000000000000001111100000000000000001111111111110000010000000000000000000000000000000000000000000000000000000000000000000000000000000000000000000
000000000000000000004000000000000022000001110000000001111111100000000000000000000000000000000000000000000222000002220000000000000000000000000000000000111000000000000000000111111111100000000000000000000000000000000000000000000000000000000000000000000000000000000000000000000000000
022000000000000000004000000000000011200001110000000001111111100000000000000000000000000000000000000000000010000000100000000000000000000000000000000000010000000000000000000111111111100000000000000000000000000000000000000000000000000000000000000000000000000000000000000000000000000
011222000000000000004000000000000011120001110000000001111111100000000000000000000000000000000000000000000000000000000000000000000000000000000000000000000000000000000000000111111111122222222222222222220000000000000000000000000000000000000000000000000000000000000000000000000000000
011111222000000000004000000000022211110001112000000001111111155555555555555555555555555555555555555555555555555555500000000000000022222222222200000000000000000000000000000011111111111111111111111111110000000000000000000000000000000000000000000000000000000000000000000000000000000
011111111200000022222222222222211111112221111000000001111111100000000000000000000000000000000000000000000000000000050000000000000011111001111100000000000000000000000000000000000000000000000000000000000000000000000000000000000000000000000000000000000000000000000000000000000000000
011111111100000001111111111111111111111111111000000001111111100000000000000000000000000000000000000000000000000000005000000000000011111001111155555555555555555555555555555555555555555555555555555555555555555555555555555555000000000000000000000000000000000000000000000000000000000
011111111000000001111111111111111111111111110000000000111111100000000000000000000000000000000000000000000000000000000500000000000001110000111000000000000000000000000000000000000000000000000000000000000000000000000000000000000000000000000000000000000000000000000000000000000000000
011111110000000000111111111111111111111111110000000000111111100000000000000000000000000000000000000000000000000000000050000000000001110000111000000000000000000000000000000000000000000000000000000000000000000000000000000000000000000000000000000000000000000000000000000000000000000
011111110000000000111111111111111111111111100000000000011111100000000000000000000000000000000000000000000000000000000005555555555551110000111000000000000000000000000000000000000000000000000000000000000000000000000000000000000000000000000000000000000000000000000000000000000000000
011111110000000000111111111111111111111111100000000000011111100000000000000000000000000000000000000000000000000000000000000000000000100000010000000000000000000000000000000000000000000000000000000000000000000000000000000000000000000000000000000000000000000000000000000000000000000
011111100000000000011111111111111111111111100000000000011111100000000000000000000000000000000000000000000000000000000000000000000000000000000000000000000000000000000000000000000000000000000000000000000000000000000000000000000000000000000000000000000000000000000000000000000000000
011110000000000000001111111111111111111111555555555555551111100000000000000000000000000000000000000000000000000000000000000000000000000000000000000000000000000000000000000000000000000000000000000000000000000000000000000000000000000000000000000000000000000000000000000000000000000
011110000000000000001111111111111111111111000000000000000111100000000000000000000000000000000000000000000000000000000000000000000000000000000000000000000000000000000000000000000000000000000000000000000000000000000000000000000000000000000000000000000000000000000000000000000000000
011100000000000000001111111111111111111111000000000000000111100000000000000000000000000000000000000000000000000000000000000000000000000000000000000000000000000000000000000000000000000000000000000000000000000000000000000000000000000000000000000000000000000000000000000000000000000
011110000000000000001111111111111111111111000000000000000111100000000000000000000000000000000000000000000000000000000000000000000000000000000000000000000000000000000000000000000000000000000000000000000000000000000000000000000000000000000000000000000000000000000000000000000000000
011111000000000000011111111111111111111111000000000000000111100000000000000000000000000000000000000000000000000000000000000000000000000000000000000000000000000000000000000000000000000000000000000000000000000000000000000000000000000000000000000000000000000000000000000000000000000
011111000000000000011111111111111111111111000000000000000111100000000000000000000000000000000000000000000000000000000000000000000000000000000000000000000000000000000000000000000000000000000000000000000000000000000000000000000000000000000000000000000000000000000000000000000000000
011111111111111111111111111111111111111111000000000000000111100000000000000000000000000000000000000000000000000000000000000000000000000000000000000000000000000000000000000000000000000000000000000000000000000000000000000000000000000000000000000000000000000000000000000000000000000
011111111111111111111111111111111111111111000000000000000011100000000000000000000000000000000000000000000000000000000000000000000000000000000000000000000000000000000000000000000000000000000000000000000000000000000000000000000000000000000000000000000000000000000000000000000000000
011111111111111111111111111111111111111111000000000000000011100000000000000000000000000000000000000000000000000000000000000000000000000000000000000000000000000000000000000000000000000000000000000000000000000000000000000000000000000000000000000000000000000000000000000000000000000
